1 1 1 1 1 1
1 0 0 0 x 1
1 0 1 1 1 1 
1 0 0 0 y 1 
1 1 1 1 1 1 
